111111111111111111111111
100000000100000000000001
100001000D00010000000001
101000000111111111111D11
100000000000000000000001
1000000000000N0000000101
100000010000000000000001
100000000000000F00000001
100000000000000000000011
100100000100000000000001
100100000D00000000000001
111111111111111111111111