111111111111111111111111
100000000144444444444441
100000000D44444444444441
101000000111111111111D11
11111111D100000000000001
1000000000000N0000000101
100000010000000000000001
100000000000000000000001
100000000111111111D11111
100100000100000000000001
100100000D00000000000001
111111111111111111111111