11111111111111111111111111111
10000000000000000000000000001
10000000000100000000000000001
10010000000000000000000000001
10000000000000000000000000001
10000000000000000100000000001
11000000000000000000000000001
10000000000000000100000000001
10000000000000000100000000001
10000000010000000000000000001
10000000000000000000000000001
11000000000000000000000000001
11111D11111111D1111D111111D11
10000000001100000100000010001
10000000000000000000000001001
10000000000000010000000001001
10000000000000000000N00000001
10000000000000000001010000001
11111111111111111111111111111
