F 0,100,0
C 0,0,0

NO   ../bonus/textures/wall.xpm    
EA   ../bonus/textures/wall2.xpm    
WE   ../bonus/textures/wall3.xpm    
SO   ../bonus/textures/wall5.xpm    

111111111111
10000N111111111
111111111111
11111
10001
11111