NO                  ../bonus/textures/wall.xpm
EA                  ../bonus/textures/wall2.xpm
WE                  ../bonus/textures/wall3.xpm
SO                  ../bonus/textures/wall5.xpm

F       255,255,255
C       255,25,255

1111
1111
11111
1N01
 111

1111
