F 0,100,0
C 0,0,0

NO   ../bonus/textures/wall.xpm    
EA   ../bonus/textures/wall2.xpm    
WE   ../bonus/textures/wall3.xpm    
SO   ../bonus/textures/wall5.xpm   

111111111111111111111111
100000000100000000000001
100001000000010000000001
101000000111111111111011
100000000000000000000001
1000000000000S0000000101
100000010000000000000001
100000000000000000000001
100000000000000000000011
111111111111111111111111
