F 0,100,0
C 0,0,0

NO   ../bonus/textures/wall.xpm    
EA   ../bonus/textures/wall2.xpm    
WE   ../bonus/textures/wall3.xpm    
SO   ../bonus/textures/wall5.xpm   

111111111111111111111111
1000000001000N0000000001
100000000000000000000001
101000000000000000001011
100000000000000000000001
100000000000000000000001
100000000000000000000001
101000000000000000001011
100000000000000000000001
100000000000000000000001
100000000000000000000001
101000000000000000001011
100000000000000000000001
100000000000000000000101
100000010000000000000001
100000000000000000000001
100000000000000000000011
111111111111111111111111
