111111111111111111111111111111111111111111111111111111111111111111111111111111
110000000000000000000000000001000000010000000100000001000000010000000100000001
100000000001111111100011111111111111111111111111111111111111111111111111111111
100000000000000000000000000001000000010000000100000001000000010000000100000001
100000001111111110011111111101111111011111110111111101111111011111110111111101
100000101000000000000000000001000000010000000100000001000000010000000100000001
100000101000000100000000000001000000010000000100000001000000010000000100000001
100000101000000000000000100001001000010010000100100001001000010010000100100001
100000101000001000000001000010010000100100001001000010010000100100001001000001
100000101000001000000000100001001000010010000100100001001000010010000100100001
100000101000001000000000111111001111110011111100111111001111110011111100111111
100000101001111111D11111100001111000011110000111100001111000011110000111100001
100000101000000000000000001111000011110000111100001111000011110000111100001111
100000101001111111111111100001111000N11110000111100001111000011110000111100001
111111111111111111111111111111111111111111111111111111111111111111111111111111 
100000101000001000000000100001001000010010000100100001001000010010000100100001
100000101000001000000000111111001111110011111100111111001111110011111100111111
100000101001111111D11111100001111000011110000111100001111000011110000111100001
100000101000000000000000001111000011110000111100001111000011110000111100001111
100000101001111111111111100001111000011110000111100001111000011110000111100001
111111111111111111111111111111111111111111111111111111111111111111111111111111
100000101000001000000000100001001000010010000100100001001000010010000100100001
100000101000001000000000111111001111110011111100111111001111110011111100111111
100000101001111111D11111100001111000011110000111100001111000011110000111100001
100000101000000000000000001111000011110000111100001111000011110000111100001111
100000101001111111111111100001111000011110000111100001111000011110000111100001
111111111111111111111111111111111111111111111111111111111111111111111111111111