1111111111111111111111111111111111111111111111111111
1100000000000000000000000000000000000000000000000001
1000000000011111111000111111110000000011111100000101
1000000000000000000000000000000000000000000000000001
1000000011111111100111111111000000000000000000000101
1000001010000000000000000000000000001000000000000101
1000001010000001000000000000000000001000000000000101
1000001010000000000000001000000000001000000000000101
10000010100000100000N0001000000000001000000000000101
1000001010000010000000001000000000001000000000000101
1000001010000010000000001111111111101111111111111101
1000001010011111111111111000000000000000000000000001
1000001010000000000000000011111111111111111111111101
1000001010011111111111111000000000000000000000000001
1111111111111111111111111111111111111111111111111111