111111111111111111111111111111
110000000000000000000000000001
100000000001111111100011111111
100000000000000000000000000001
100000001111111110011111111101
100000101000000000000000000001
100000101000000100000000000001
100000101000000000000000100001
10000010100000100000N000100001
100000101000001000000000100001
100000101000001000000000111111
100000101001111111D11111100001
100000101000000000000000001111
100000101001111111111111100001
111111111111111111111111111111