F 200,100,0
C 0,0,0

NO   ../bonus/textures/wall.xpm    
EA   ../bonus/textures/wall2.xpm    
WE   ../bonus/textures/wall3.xpm    
SO   ../bonus/textures/wall5.xpm    

111111111111
1D1000000011111111
1110000N0000000011
1110000000000001111
1111111111D111111
        11011
        11011
        11011
        11011
        11011
        11011
    111111D11111            111111111111
11111D10000000111111111111111000000011111111
1110000000000000D00000000000D000000000000011
11100000000000011111111111111110000001111111
11111111111111111             11111111111111111