1111111111111111111111111111111111111
1000000000000000001100000000000000001
1000000000010000001100000000100000001
1001000000000000001100100000000000001
1000000000000100000000000010000001101
1000000000000000000000000000000001101
1100000000000100000000000010000001111
1000000000000100000000000010000001101
10000000000000000000N0000000000001101
1000000000000000000000000000000001101
110000000000111D111110D11111D11111111
11111D1111110100001100000010000111111
1000000000110000000000000000000001101
1000000000000000000000011000000001101
1000000000001001101100000000000010011
1000000000000011001000000000000000001
1000000000000001101100000000000000001
1111111111111111111111111111111111111
