F 0,100,0
C 0,0,0

NO   ../bonus/textures/wall.xpm    
EA   ../bonus/textures/wall2.xpm    
WE   ../bonus/textures/wall3.xpm    
SO   ../bonus/textures/wall5.xpm   

111111111111111111111111111111111111111111111111111111111111111111111
100000000000000000001000000000000000100000000000000010000000000000001
100000000000000000000000000000000000000000000000000000000000000000001
100100000000000000001010000000000000101000000000000010100000000000001
100000000000000001101000001000000110100000100000011010000010000001101
100000000000000001101000000000000110100000000000011010000000000001101
110000000000000001111000001000000111100000100000011110000010000001111
100000000000000001101000001000000110100000100000011010000010000001101
100000000000000001101000000000000110100000000000011010000000000001101
100000000000000001101000000000000110100000000000011010000000000001101
1100000000001111111110D11111D111111110D11111D111111110D11111D11111111
11111D111111000111111000001000011111100000100001111110000010000111111
100000000011000011010000000000000000000000000000110100000000000011001
1000000000000000011010011000000000N1000000000001101001100000000110001
100000000000100010011000000000000000000000000000100110000000000010011
100000000000000000001000000000000000100000000000000010000000000000001
100000000000000000001000000000000000100000000000000010000000000000001
111111111111111111111111111111111111111111111111111111111111111111111
110000000000111110D11111D111111110D11111D111111110D11111D111111110D11
11111D111111011110000010000111111000001000011111100000100001111110001
100000000011001100000000000011010000000000001101000000000000110100001
100000000000001100011000000001101001100000000110100110000000011010011
100000000000110010000000000010011000000000001001100000000000100110001
100000000000000000000000000000001000000000000000100000000000000010001
100000000000000000000000000000001000000000000000100000000000000010001
111111111111111111111111111111111111111111111111111111111111111111111
