111111111111111111111111111111111111111111111111111111111111111111111111111111111111111111111111111111111111111111111111111111111111111111111111111111111111111111111111111111111111111111111111111111111111111111111111111111111111111111111111111111111111111111111111111111111111111111111111111111111111111111111111111111111111111111111111111111111111111111111111111111111111111111111111111111111111111111111111111111111111111111111111111111111111111111111111111111111111111111111111111111111111111111111111111111111111111111111111111111111111111111111111111111111111111111111111111111111111111111111111111111111111111111111111111111
100000000000000000000000000000000000000000000000000000000000000000000000000000000000001100000000000000000000000000000000000000001100000000000000000000000000000000000000000000011000000000000000000000000000110000000000000000000000000110000000000000000000000000001100000000000000000000000001100000000000000000000000000011000000000000000000000000011000000000000000000000000000110000000000000000000000000110000000000000000000000000001100000000000000000000000001100000000000000000000000000011000000000000000000000000000000000000000000000000000000110000000000000000000000000000000000000000000001100000000000000000000000000000000000000001
100000000001000000000000000011000000000010000000000000000110000000000100000000000000001100000000001110000000000100000000000000001100000000001000000000000001100000000001000000011000000000010000000000000000110000000000100000000000000110000000000100000000000000001100000000001000000000000001100000000001000000000000000011000000000010000000000000011000000000010000000000000000110000000000100000000000000110000000000100000000000000001100000000001000000000000001100000000001000000000000000011000000000010000000000000011000000000010000000000000000110000000000100000000000000000100000000000000001100000000001000000000000000000000000000001
100100000000000000000000000011001000000000000000000000000110010000000000000000000000001100100000000110010000000000000000000000001100100000000000000000000001100100000000000000011001000000000000000000000000110010000000000000000000000110010000000000000000000000001100100000000000000000000001100100000000000000000000000011001000000000000000000000011001000000000000000000000000110010000000000000000000000110010000000000000000000000001100100000000000000000000001100100000000000000000000000011001000000000000000000000011001000000000000000000000000110010000000000000000000000000000000000000000001100100000000000000000000000000000000000001
100000000000000000000000000011000000000000010000000000010000000000010000000000000110000000000000000110000000000000100000000000100000000000100000000000001101100000000000001000011000000000000010000000000010000000000010000000000000110110000000000000100000000000100000000000100000000000001101100000000000001000000000001000000000001000000000000011011000000000000010000000000010000000000010000000000000110110000000000000100000000000100000000000100000000000001101100000000000001000000000001000000000001000000000000011011000000000000010000000000010000000000010000000000000110000000100000000000100000000000100000000000001101000000000000001
100000000000000001000000000011000000000000000000000000000000000000000000000000000110000000000000000000000000000000000000000000000000000000000000000000001101100000000000000000011000000000000000000000000000000000000000000000000000110110000000000000000000000000000000000000000000000000001101100000000000000000000000000000000000000000000000000011011000000000000000000000000000000000000000000000000000110110000000000000000000000000000000000000000000000000001101100000000000000000000000000000000000000000000000000011011000000000000000000000000000000000000000000000000000110000000000000000000000000000000000000000000001101000000000000001
110000000000000000000000000011100000000000010000000000010000000000010000000000000111000000000000000111000000000000100000000000100000000000100000000000001111110000000000001000011100000000000010000000000010000000000010000000000000111111000000000000100000000000100000000000100000000000001111110000000000001000000000001000000000001000000000000011111100000000000010000000000010000000000010000000000000111111000000000000100000000000100000000000100000000000001111110000000000001000000000001000000000001000000000000011111100000000000010000000000010000000000010000000000000111000000100000000000100000000000100000000000001111100000000000001
100000000000000001000000000011000000000000010000000000010000000000010000000000000110000000000000000110000000000000100000000000100000000000100000000000001101100000000000001000011000000000000010000000000010000000000010000000000000110110000000000000100000000000100000000000100000000000001101100000000000001000000000001000000000001000000000000011011000000000000010000000000010000000000010000000000000110110000000000000100000000000100000000000100000000000001101100000000000001000000000001000000000001000000000000011011000000000000010000000000010000000000010000000000000110000000100000000000100000000000100000000000001101000000000000001
100000000000000001000000000011000000000000000000000000000000000000000000000000000110000000000000000110000000000000000000000000000000000000000000000000001101100000000000000000011000000000000000000000000000000000000000000000000000110110000000000000000000000000000000000000000000000000001101100000000000000000000000000000000000000000000000000011011000000000000000000000000000000000000000000000000000110110000000000000000000000000000000000000000000000000001101100000000000000000000000000000000000000000000000000011011000000000000000000000000000000000000000000000000000110000000000000000000000000000000000000000000001101000000000000001
100000000000000000000000000011000000000000000000000000000000000000000000000000000110000000000000000110000000000000000000000000000000000000000000000000001101100000000000000000011000000000000000000000000000000000000000000000000000110110000000000000000000000000000000000000000000000000001101100000000000000000000000000000000000000000000000000011011000000000000000000000000000000000000000000000000000110110000000000000000000000000000000000000000000000000001101100000000000000000000000000000000000000000000000000011011000000000000000000000000000000000000000000000000000110000000000000000000000000000000000000000000001101000000000000001
1100000000000000000000000000111000011111D1111D111111D1111D111111D1111D11111000000111000011111000000111000011111D1111D111111D1111D111111D1111D11111000000111111000011111D1111D11111000011111D1111D111111D1111D111111D1111D11111000000111111000011111D1111D111111D1111D111111D1111D11111000000111111000011111D1111D111111D1111D111111D1111D11111000000111111000011111D1111D111111D1111D111111D1111D11111000000111111000011111D1111D111111D1111D111111D1111D11111000000111111000011111D1111D111111D1111D111111D1111D11111000000111111000011111D1111D111111D1111D111111D1111D11111000000111111D1111D111111D1111D111111D1111D111110000001111100001111000001
11111D11111111D1111D111111D1111111D01100000100001100000100001100000100001101111D1111111D011001011D1111111D01100000100001100000100001100000100001101111D1111111111D0110000010000111111D01100000100001100000100001100000100001101111D1111111111D01100000100001100000100001100000100001101111D1111111111D01100000100001100000100001100000100001101111D1111111111D01100000100001100000100001100000100001101111D1111111111D01100000100001100000100001100000100001101111D1111111111D01100000100001100000100001100000100001101111D1111111111D01100000100001100000100001100000100001101111D1111100000100001100000100001100000100001101111D111111111D0110000011
100000000011000001000000100011000000000000000000000000000000000000000000000001000110000000000001000110000000000000000000000000000000000000000000000010001101100000000000000000011000000000000000000000000000000000000000000000001000110110000000000000000000000000000000000000000000000010001101100000000000000000000000000000000000000000000000100011011000000000000000000000000000000000000000000000001000110110000000000000000000000000000000000000000000000010001101100000000000000000000000000000000000000000000000100011011000000000000000000000000000000000000000000000001000110000000000000000000000000000000000000000010001101000000000000001
1000000000000000000000000100110000000000010000000000N1000000000001000000000000100110000000000000100110000000000010000000000N100000000000100000000000010011011000000000001000000110000000000010000000000N1000000000001000000000000100110110000000000010000000000N1000000000001000000000000100110110000000000010000000000N1000000000001000000000000100110110000000000010000000000N1000000000001000000000000100110110000000000010000000000N1000000000001000000000000100110110000000000010000000000N1000000000001000000000000100110110000000000010000000000N1000000000001000000000000100110000010000000000N10000000000010000000000001001101000000000000011
100000000000000100000000010011000000000000001000000000100110000000000000010000100000000000000000100110000000000000010000000001001100000000000000100001001101100000000000000100011000000000000001000000000100110000000000000010000100110110000000000000010000000001001100000000000000100001001101100000000000000100000000010011000000000000001000010011011000000000000001000000000100110000000000000010000100110110000000000000010000000001001100000000000000100001001101100000000000000100000000010011000000000000001000010011011000000000000001000000000100110000000000000010000100110000000010000000001001100000000000000100001001101000000000000011
100000000000000000000000000110000000000000000000000000011000000000000000000000001100000000000000001100000000000000000000000000110000000000000000000000011001000000000000000000010000000000000000000000000011000000000000000000000001100100000000000000000000000000110000000000000000000000011001000000000000000000000000001100000000000000000000000110010000000000000000000000000011000000000000000000000001100100000000000000000000000000110000000000000000000000011001000000000000000000000000001100000000000000000000000110010000000000000000000000000011000000000000000000000001100000000000000000000110000000000000000000000011000000000000000001
100000000000000000010100000011000000000000000000101000000110000000000000000000000110000000000000000110000000000000000001010000000000000000000000000000001101100000000000000000011000000000000000000101000000110000000000000000000000110110000000000000000001010000001100000000000000000000001101100000000000000000010100000011000000000000000000000011011000000000000000000101000000110000000000000000000000110110000000000000000001010000001100000000000000000000001101100000000000000000010100000011000000000000000000000011011000000000000000000101000000110000000000000000000000110000000000001010000001100000000000000000000001101000000000000001
111111111111111111111111111111111111111111111111111111111111111111111111111111111111111111111111111111111111111111111111111111111111111111111111111111111111111111111111111111111111111111111111111111111111111111111111111111111111111111111111111111111111111111111111111111111111111111111111111111111111111111111111111111111111111111111111111111111111111111111111111111111111111111111111111111111111111111111111111111111111111111111111111111111111111111111111111111111111111111111111111111111111111111111111111111111111111111111111111111111111111111111111111111111111111111111111111111111111111111111111111111111111111111111111111111
