1111111111111111111111111111111111111111
1000000000000000001100000000000000000011
1000000000010000001100000000100000000011
1001000000000000001100100000000000000011
1000000000000100000000000010000001100001
1000000000000000000000000000000001100001
1100000000000100000000000010000001110001
1000000000000100000000000010000001100001
1000000000000000000000000000000001100001
1000000000000000000000000000000001100001
110000000000111D111111D11111D11111110001
11111D1111110100001100000010000111111111
1000000000110000000000000000000001100001
1000000000000000000000011000000001100001
1000000000001001101100000000000010010011
10000000000000110010000N0000000000001101
1000000000000001101100000000000000000011
1111111111111111111111111111111111111111
