F 0,100,0
C 0,0,0

NO   ../bonus/textures/wall.xpm    
EA   ../bonus/textures/wall2.xpm    
WE   ../bonus/textures/wall3.xpm    
SO   ../bonus/textures/wall5.xpm   

111111111111111111111111111111111111111111111111111111111111111111
100000000000000000010000001000000000000000100000010000000000000001
100000000000000000000000000000000000000000100000000000000000000001
110000000000000000010000001000000000000000100000010100000000000001
100001000000110111010001101000100000000000000000000000010000001101
1000000000000000000000001010000N0000000000000000000000000000001101
100001000000100000010001111000100000000000000000000000010000001111
100001000000100000010001101000100000000000000000000000010000001101
10000000000011001101000110100000000000011011D111010000000000001101
100000000000110011010001101000000000000110100011010000000000001101
100001000000000000000000000000000000000111100011110000010000001111
100001000000000000000000000000000000000110100011010000010000001101
100000000000000000000000000000000000000110100011010000000000001101
100000000000000000000000000000000000000110100011010000000000001101
100001000000000000000000000000000000000111100011110000010000001111
100001000000110111010001101000100000000110100011010000010000001101
100000000000110011010001101000000000000110100011010000000000001101
1000000000001100110100011010000000000000D0000011010000000000001101
111111111111111111111111111111111111111111111111111111111111111111
